..#.#.#.#.#.###..##
###..#..##..#.#..#.
#....#..#.#.###.##.
...................
###################
#***#*#*#***#*****#
##*##*#*#***##*#*##
#***#***#*###*****#
###################
...................
.###.#####.##..###.
.#...#$%X#.###.##..
.###.#####.#.#.###.
