###################
#               XX#
#               XX#
#######  ##########
#  %        % %   #
#        $    %   #
#                 #
###################
