..#####
###  $##
#  %X  #
#  X%X #
### *% #
..#   ##
..#####
