.####..#####
##  #..#   #
# % ####%  #
#  %XXXX % #
##    # $ ##
.##########

