####
#$ ###
#    ###
# #%  X#
# % %XX#
# % X###
#  ###
####
