...#####
.###  $###
## % #   #
# %   %  #
# # ##% ##
#XXXX   #
#########
