########
#  #   #
# %XX% #
#$%X* ##
# %XX% #
#  #   #
########
