.#######
##     ##
# % %%  #
#XXXXXX##
# %% % #
### $###
..####
