..######
..#    ###
..# %    #
### % ## #
#XXX %   #
#XXX%#% ##
#### # % #
...#  $  #
...#######
