######
#    #
# %%%##
#  #XX###
##  XX% #
.# $    #
.########
