.#######
.#XXXX #
###XXX%###
#  %#% % #
# %%  #% #
#    #   #
#### $ ###
...#####
