#######
#XX%XX#
#XX#XX#
# %%% #
#  %  #
# %%% #
#  #$ #
#######
