...######
...# XXX#
####XXXX#
#  ###% ###
# % %  %% #
#$ % %    #
#   ###   #
#####.#####
