########
#XXXXXX#
#  % # ##
# % # % #
##% % % #
.#  $   #
.########
