.######
.#X XX#
.#X %X#
###  %##
# %  % #
# #%## #
#   $  #
########
