#########
#   ##  #
# # % % #
#  *X#  #
## #X$X##
##%###*###
#        #
#   ## # #
######   #
.....#####
