.....#####
.#####   #
.# XX %# #
.# #X*   #
## *X#% ##
# %  %  #
#   ## $#
#########
