...#####
.###   ###
##  $% % #
#  ## ## ##
# %X#X%   #
# #X#*#   #
# %XXX  ###
###%# ###
..#   #
..#####
