....#####
...##   ####
...# XX* % #
#### #X%   #
#    X*X#$##
# # ##%## #
#     % % #
##  #   ###
.########
