######
#    #
# %  ####
# %*XX* #
# *XX*% #
####  % #
...# $  #
...######
