############
#    XXX % #
# %%%*** %$#
#    XXX % #
############
