##########
##       #
#   #%#% #
# %%  X%X#
# $###XXX#
##########
