#####
#   ######
# % XX % #
##% XX%%$#
.#  XX % #
.#########
