..#####
..#   ######
###%#X     #
# % XXX# % #
#$ %X#*%   #
####    ####
...######

