#########
#   *   #
# % * % #
#*XX***X#
# $%X % #
#   *   #
#########
